1111111111111111111
1111111111111111111111111
1111111000000000000000001111111
1111110000000000000000000000000111111
1111110000000000000000000000000000000111111
111100000000000000000000000000000000000001111
1111000000000000000000000000000000000000000001111
11110000000000000000000000000000000000000000000001111
1110000000000000000000000000000000000000000000000000111
11110000000000000000000000000000000000000000000000000001111
1111000000000000000000000000000011000000000000000000000001111
111000000000000000000000000000001111000000000000000000000000111
11100000000000000000000000000000001100000000000000000000000000111
1110000000000000000000000000000000000000000000000000000000000000111
111000000000000000000000000000000000000000000000000000000000000000111
11100000000000000000000000000000000000000000000000000000000000000000111
1110000000000000000000000000000000000000000000000000000000000000000000111
111000000000000000000000000000000000000000000000000000000000000000000000111
11100000000000000000000000000000000000000000000000000000000011100000000000111
110000000000000000011111111000000000000000000000111000000000111000000000000111
1110000000000000000111111111000000000000000000000111100000000111000000000000111
111000000000000000000011111000000000000000000000001110000000000000000000000000111
1100000010000000000000000000000000000000000000000001100000000000000000000000000111
110000001110000000000000000000000000000000000000000000000000000000000000000000000111
110000001110000000000000000000000000000000000000000000000000000000000000000000000111
11000000000000000000000000000000001111111111111111100000000000000000000000000000000111
111000000000000000000000000000011111111111111111111111110000000000000000000000000000111
1100000000000000000000000001111111100000000000000000111111110000000000000000000000000111
11100000000000000000000000111111000000000000000000000000011111100000000000000000000000111
11000000000000000000000011111000000000000000000000000000000011111000000000000000000000011
1110000000000000000000011111000000000000000000000000000000000001111100000000000000000000111
1100000000000000000000111000000000000000000000000000000000000000001110000000000000000000011
111000000000000000000111100000000000000000000000000000000000000000001111000000000000000000111
110000000000000000001110000000000000000000000000000000000000000000000011100000000000000000011
110000000000000000011100000000000000000000000000000000000000000000000001110000000000000000011
110000000000000001111000000000000000000000000000000000000000000000000000111100000011000000011
11000000000000000111000000000000000000000000000000000000000000000000000000011100000111000000011
11000000000000000110000000000000000000000000000000000000000000000000000000001100000111000000011
11000000000000001100000000000000000000000000000000000000000000000000000000000110000111000000011
1100000000000000111000000000000000000000000000000000000000000000000000000000001110000000000000011
1100000000000000110000000000000000000000000000000000000000000000000000000000000110000000000000011
1100000000000001100000000000000000000000000000000000000000000000000000000000000011000000000000011
1100000000000011000000000000000000000000000000000000000000000000000000000000000001100000000000011
110000000000000110000000000000000000000000000000000000000000000000000000000000000011000000000000011
110000000000001110000000000000000000000000000000000000000000000000000000000000000011100000000000011
110000000000001100000000000000000000000000000000000000000000000000000000000000000001100000000000011
110000000000001100000000000000000000000000000000000000000000000000000000000000000001100000000000011
110000000000011100000000000000000000000000000000000000000000000000000000000000000001110000000000011
110000000000011000000000000000000000000000000000000000000000000000000000000000000000110000000000011
110000000000011000000000000000000000000000000000000000000000000000000000000000000000110000000000011
110000000000000000000000000000000000000000000000000000000000000000000000000000000000110000000110011
1110000000000000000000000000000000000000000000000000000000000000000000000000000000000110000000110011
1110000000000000000000000000000000000000000000000000000000000000000000000000000000000110000001111011
1110000000000011000000000000000000000000000000000000000000000000000000000000000000000110000000110011
1110000000000011000000000000000000000000000000000000000000000000000000000000000000000110000000000011
1110000000000011000000000000000000000000000000000000000000000000000000000000000000000110000000000011
110000000000011000000000000000000000000000000000000000000000000000000000000000000000110000000000011
110000000000001100000000000000000000000000000000000000000000000000000000000000000001100000000000011
110000000000001100000000000000000000000000000000000000000000000000000000000000000001100000000000011
110000000000001100000000000000000000000000000000000000000000000000000000000000000001100000000000011
110000000000000110000000000000000000000000000000000000000000000000000000000000000011000000000000011
110000000000000110000000000000000000000000000000000000000000000000000000000000000011000000000000011
110000000000000011000000000000000000000000000000000000000000000000000000000000000110000000000000011
110000000000000011000000000000000000000000000000000000000000000000000000000000000110000000000000011
1100000000000000110000000000000000000000000000000000000000000000000000000000000110000000000000011
1100000000000000111000000000000000000000000000000000000000000000000000000000001110000000000000011
1100000000000000011100000000000000000000000000000000000000000000000000000000011100000000000000011
1100000000000000001110000000000000000000000000000000000000000000000000000000111000000000000000011
11000000000000000011100000000000000000000000000000000000000000000000000000111000000000000000011
11000000000000000001110000000000000000000000000000000000000000000000000001110000000000000000011
11000000000000000000111000000000000000000000000000000000000000000000000011100000000000000000011
110000000000000000001111000000000000000000000000000000000000000000000111100000000000000000011
110000000000000000000011110000000000000000000000000000000000000000011110000000000000000000011
110000000000000000000000111000000000000000000000000000000000000000111000000000000000000000011
111000000000000000000000011111000000000000000000000000000000000111110000000000000000000000111
1100000000000000000000000011111100000000000000000000000000011111100000000000000000000000011
1110000000000000000000000000111111100000000000000000000011111110000000000000000000000000111
11000000000000000000000000000011111111110000000001111111111000000000111000000000000000011
11100000000000000000000000000000001111111111111111111110000000000000111100000000000000111
110000000000000011000000000000000000001111111111100000000000000000011100000000000000011
111000000000000011100000000000000000000000000000000000000000000000001100000000000000111
1100000000000001110000000000000000000000000000000000000000000000000000000000000000011
11000000000000011100000000000000000000000000000000000000000000000000000000000000011
11000000000000011110000000000000000000000000000000000000000000000000000000000000011
110000000000000111000000000000000000000000000000000000000000000000000000000000011
111000000000000111000000000011000000000000000000000000000000000000000000000000111
1110000000000011110000000001110000000000000000000000000000000000000000000000111
11000000000000111000000000111100000000000000000000000000000000000000000000011
11100000000000111100000000011100000000001100000000000000000000000000000000111
111000000000001110000000001111000000000111000000000000000000000000000000111
1110000000000011000000000011100000000011100000000000000000000000000000111
11100000000000000000000001111000000001111000000000000000000000000000111
111000000000000000000000011100000000011100000000000000000000000000111
1110000000000000000000001110000000001111000000000000000000000000111
11100000000000000000000011100000000111100000000000000000000000111
111000000000000000000001110000000001111000000000000000000000111
111100000000000000000001100000000011110000000000000000000111
11110000000000000000000000000000001110000000000000000001111
1110000000000000000000000000000001110000000000000000111
11110000000000000000000000000000111000000000000001111
1111000000000000000000000000000110000000000001111
111100000000000000000000000000000000000001111
1111110000000000000000000000000000000111111
1111110000000000000000000000000111111
1111111000000000000000001111111
1111111111111111111111111
1111111111111111111