11111111111111111111111111111111111111111111111111
11111110000000000000000011111110000000011111111111
11111100000000000000000000000000000000011111111111
11111100000000000000000000000000000000011111111111
11110000000000000000000000000000000000011111111111
11110000000001111000000000000000000000011111111111
11110000000001111000000000000000000000011111111111
11100000000001111000000000000000000000011111111111
11110000000001111000000000000000000000011111111111
11110000000000111110000000000000000000011111111111
11100000000000000111111000000000000000011111111111
11100000000000000000111110000000000000011111111111
11100000000000000000011111110000000000011111111111
11100000000000000000000000000000000000011111111111
11100000000000000000000000000000000000011111111111
11100000000000000000000000000000000000011111111111
11100000000000000000000000000000000000011111111111
11000000000000000001111111100000000000011111111111
11100000000000000001111111110000000000011111111111
11100000000000000000001111100000000000011111111111
11000000100000000000000000000000000000011111111111
11000000111000000000000000000000000000011111111111
11000000111000000000000000000000000000011111111111
11000000000000000000000000000000000000011111111111
11100000000000000000000000000000000000111111111111
11000000000000000000000000011110000000011111111111
11100000000000000000000000111111000000001111111111
11000000000000000000000011111000000000111111111111
11100000000000000000000111110000000000111111111111
11000000000000000000001110000000000000111111111111
11000000000000000000111000000000000000111111111111
11000000000000000001110000000000000000111111111111
11000000000000000111100000000000000000111111111111
11000000000000000111000000000000000000111111111111
11000000000000000110000000000000000000111111111111
11000000000000001100000000000000000000111111111111
11000000000000001110000000011000000000111111111111
11000000000000001100000000011000000000111111111111
11000000000000011000000000000011000000111111111111
11000000000000110000000000000011000000111111111111
11000000000000011000000000011000000001111111111111
11000000000000111000000000011000000000111111111111
11000000000000110000000000000011000000111111111111
11000000000000110000000000000011000000011111111111
11000000000001110000000000000000000000011111111111
11000000000001100000000000000000000000111111111111
11111111111111111111111111111111111111111111111111
11111111111111111111111111111111111111111111111111
11111111111111111111111111111111111111111111111111