0000000000000000000000000000000000000000000000000000000000000000000000000000000000000000000000000000
0000000000000000000000000000000000000000011111111111111111110000000000000000000000000000000000000000
0000000000000000000000000000000000000011111111111111111111111110000000000000000000000000000000000000
0000000000000000000000000000000000011111110000000000000000011111110000000000000000000000000000000000
0000000000000000000000000000000011111100000000000000000000000001111110000000000000000000000000000000
0000000000000000000000000000011111100000000000000000000000000000001111110000000000000000000000000000
0000000000000000000000000000111100000000000000000000000000000000000001111000000000000000000000000000
0000000000000000000000000011110000000000000000000000000000000000000000011110000000000000000000000000
0000000000000000000000001111000000000000000000000000000000000000000000000111100000000000000000000000
0000000000000000000000011100000000000000000000000000000000000000000000000001110000000000000000000000
0000000000000000000001111000000000000000000000000000000000000000000000000000111100000000000000000000
0000000000000000000011110000000000000000000000000000110000000000000000000000011110000000000000000000
0000000000000000000111000000000000000000000000000001111000000000000000000000000111000000000000000000
0000000000000000001110000000000000000000000000000000110000000000000000000000000011100000000000000000
0000000000000000011100000000000000000000000000000000000000000000000000000000000001110000000000000000
0000000000000000111000000000000000000000000000000000000000000000000000000000000000111000000000000000
0000000000000001110000000000000000000000000000000000000000000000000000000000000000011100000000000000
0000000000000011100000000000000000000000000000000000000000000000000000000000000000001110000000000000
0000000000000111000000000000000000000000000000000000000000000000000000000000000000000111000000000000
0000000000001110000000000000000000000000000000000000000000000000000000001110000000000011100000000000
0000000000001100000000000000000111111110000000000000000000001110000000001110000000000001100000000000
0000000000011100000000000000001111111110000000000000000000001111000000001110000000000001110000000000
0000000000111000000000000000000011111000000000000000000000001110000000000000000000000000111000000000
0000000000110000001000000000000000000000000000000000000000000110000000000000000000000000011000000000
0000000001100000011100000000000000000000000000000000000000000000000000000000000000000000001100000000
0000000001100000011100000000000000000000000000000000000000000000000000000000000000000000001100000000
0000000011000000000000000000000000000000001111111111111111100000000000000000000000000000000110000000
0000000111000000000000000000000000000011111111111111111111111110000000000000000000000000000111000000
0000000110000000000000000000000000111111110000000000000000011111111000000000000000000000000011000000
0000001110000000000000000000000011111100000000000000000000000001111110000000000000000000000011100000
0000001100000000000000000000001111100000000000000000000000000000001111100000000000000000000001100000
0000011100000000000000000000111110000000000000000000000000000000000011111000000000000000000001110000
0000011000000000000000000001110000000000000000000000000000000000000000011100000000000000000000110000
0000111000000000000000000111100000000000000000000000000000000000000000001111000000000000000000111000
0000110000000000000000001110000000000000000000000000000000000000000000000011100000000000000000011000
0000110000000000000000011100000000000000000000000000000000000000000000000001110000000000000000011000
0000110000000000000001111000000000000000000000000000000000000000000000000000111100000011000000011000
0001100000000000000011100000000000000000000000000000000000000000000000000000001110000011100000001100
0001100000000000000011000000000000000000000000000000000000000000000000000000000110000011100000001100
0001100000000000000110000000000000000000000000000000000000000000000000000000000011000011100000001100
0011000000000000001110000000000000000000000000000000000000000000000000000000000011100000000000000110
0011000000000000001100000000000000000000000000000000000000000000000000000000000001100000000000000110
0011000000000000011000000000000000000000000000000000000000000000000000000000000000110000000000000110
0011000000000000110000000000000000000000000000000000000000000000000000000000000000011000000000000110
0110000000000000110000000000000000000000000000000000000000000000000000000000000000011000000000000011
0110000000000001110000000000000000000000000000000000000000000000000000000000000000011100000000000011
0110000000000001100000000000000000000000000000000000000000000000000000000000000000001100000000000011
0110000000000001100000000000000000000000000000000000000000000000000000000000000000001100000000000011
0110000000000011100000000000000000000000000000000000000000000000000000000000000000001110000000000011
0110000000000011000000000000000000000000000000000000000000000000000000000000000000000110000000000011
0110000000000011000000000000000000000000000000000000000000000000000000000000000000000110000000000011
0110000000000011000000000000000000000000000000000000000000000000000000000000000000000110000000110011
1110000000000011000000000000000000000000000000000000000000000000000000000000000000000110000000110011
1110000000000011000000000000000000000000000000000000000000000000000000000000000000000110000001111011
1110000000000011000000000000000000000000000000000000000000000000000000000000000000000110000000110011
1110000000000011000000000000000000000000000000000000000000000000000000000000000000000110000000000011
1110000000000011000000000000000000000000000000000000000000000000000000000000000000000110000000000011
0110000000000011000000000000000000000000000000000000000000000000000000000000000000000110000000000011
0110000000000001100000000000000000000000000000000000000000000000000000000000000000001100000000000011
0110000000000001100000000000000000000000000000000000000000000000000000000000000000001100000000000011
0110000000000001100000000000000000000000000000000000000000000000000000000000000000001100000000000011
0110000000000000110000000000000000000000000000000000000000000000000000000000000000011000000000000011
0110000000000000110000000000000000000000000000000000000000000000000000000000000000011000000000000011
0110000000000000011000000000000000000000000000000000000000000000000000000000000000110000000000000011
0110000000000000011000000000000000000000000000000000000000000000000000000000000000110000000000000011
0011000000000000001100000000000000000000000000000000000000000000000000000000000001100000000000000110
0011000000000000001110000000000000000000000000000000000000000000000000000000000011100000000000000110
0011000000000000000111000000000000000000000000000000000000000000000000000000000111000000000000000110
0011000000000000000011100000000000000000000000000000000000000000000000000000001110000000000000000110
0001100000000000000001110000000000000000000000000000000000000000000000000000011100000000000000001100
0001100000000000000000111000000000000000000000000000000000000000000000000000111000000000000000001100
0001100000000000000000011100000000000000000000000000000000000000000000000001110000000000000000001100
0000110000000000000000001111000000000000000000000000000000000000000000000111100000000000000000011000
0000110000000000000000000011110000000000000000000000000000000000000000011110000000000000000000011000
0000110000000000000000000000111000000000000000000000000000000000000000111000000000000000000000011000
0000111000000000000000000000011111000000000000000000000000000000000111110000000000000000000000111000
0000011000000000000000000000000111111000000000000000000000000000111111000000000000000000000000110000
0000011100000000000000000000000001111111000000000000000000000111111100000000000000000000000001110000
0000001100000000000000000000000000001111111111000000000111111111100000000011100000000000000001100000
0000001110000000000000000000000000000000111111111111111111111000000000000011110000000000000011100000
0000000110000000000000011000000000000000000001111111111100000000000000000011100000000000000011000000
0000000111000000000000011100000000000000000000000000000000000000000000000001100000000000000111000000
0000000011000000000000011100000000000000000000000000000000000000000000000000000000000000000110000000
0000000001100000000000001110000000000000000000000000000000000000000000000000000000000000001100000000
0000000001100000000000001111000000000000000000000000000000000000000000000000000000000000001100000000
0000000000110000000000000111000000000000000000000000000000000000000000000000000000000000011000000000
0000000000111000000000000111000000000011000000000000000000000000000000000000000000000000111000000000
0000000000011100000000000111100000000011100000000000000000000000000000000000000000000001110000000000
0000000000001100000000000011100000000011110000000000000000000000000000000000000000000001100000000000
0000000000001110000000000011110000000001110000000000110000000000000000000000000000000011100000000000
0000000000000111000000000001110000000001111000000000111000000000000000000000000000000111000000000000
0000000000000011100000000000110000000000111000000000111000000000000000000000000000001110000000000000
0000000000000001110000000000000000000000111100000000111100000000000000000000000000011100000000000000
0000000000000000111000000000000000000000011100000000011100000000000000000000000000111000000000000000
0000000000000000011100000000000000000000011100000000011110000000000000000000000001110000000000000000
0000000000000000001110000000000000000000001110000000011110000000000000000000000011100000000000000000
0000000000000000000111000000000000000000001110000000001111000000000000000000000111000000000000000000
0000000000000000000011110000000000000000000110000000001111000000000000000000011110000000000000000000
0000000000000000000001111000000000000000000000000000000111000000000000000000111100000000000000000000
0000000000000000000000011100000000000000000000000000000011100000000000000001110000000000000000000000
0000000000000000000000001111000000000000000000000000000011100000000000000111100000000000000000000000
0000000000000000000000000011110000000000000000000000000001100000000000011110000000000000000000000000
0000000000000000000000000000111100000000000000000000000000000000000001111000000000000000000000000000
0000000000000000000000000000011111100000000000000000000000000000001111110000000000000000000000000000
0000000000000000000000000000000011111100000000000000000000000001111110000000000000000000000000000000
0000000000000000000000000000000000011111110000000000000000011111110000000000000000000000000000000000
0000000000000000000000000000000000000011111111111111111111111110000000000000000000000000000000000000
0000000000000000000000000000000000000000011111111111111111110000000000000000000000000000000000000000
