00000000000000000000000000000000000000000000000000
00011111111111111111111111111111111111111111111100
00100000000000000000000000000000000000000000000010
01000000000000000000000000000000000000000000000001
01000000000000000000000000000000000000000000000001
01000000000000001111110000000000000000000000000001
01000000000000000000100000001111111000000000000001
01000000000011000000000000000000001000000000000001
01000000000011000000000000000000011100000000000001
01000000000000010000000000000000001000000000000001
01000000010000000000000000000000000000010000000001
01000000010000000000000000000000000000010000000001
01000000010000011000011000000000000000010000000001
01000000010000011000011000000000000000010000000001
01000000010000000000000000000000000000010000000001
01000000010000000000000000000000000000010000000001
01000000010011100110011000000000000000010000000001
01000000010001000000011000000000000000010000000001
01000000010000000000000000000000000000010000000001
01000000010000000000000000000000000000010000000001
01000000010000000000000000000000000000010000000001
01000000010011100110011000000000000000010000000001
01011001110000000000000000000000000000010000000001
01001001110000000000000000000000000000010000000001
01000000010000000000000000000000000000010000000001
01001001110000000000000000000000000000010000000001
01011001011111111111111111111111111111100000000001
01000000000000000000000000000000000000000000000001
01000000000000000000000000000000000000000000000001
01000000000000000000000000000000000000000000000001
01000000000011111111111111111111111000000000000001
01000000000000000000000000000000000000000000000001
01000000000000000000000000000000000000000000000001
01000000000000000000000000000000000000000000000001
00100000000000000000000000000000000000000000000010
00011111111111111111111111111111111111111111111100
