1111111111111111111111111111111111111111111111111
1000000000000000000000000000000000000000000000111
1000000000000000000000000000000000000000000000001
1000000000000000000000000000000000000000000000001
1000000000000001111110000000000000000000000000001
1000000000000000000100000001111111000000000000001
1000000000011000000000000000000001000000000000001
1000000000011000000000000000000011100000000000001
1000000000000010000000000000000001000000000000001
1000000010000000000000000000000000000010000000001
1000000010000000000000000000000000000010000000001
1000000010000011000011000000000000000010000000001
1000000010000011000011000000000000000010000000001
1000000010000000000000000000000000000010000000001
1000000010000000000000000000000000000010000000001
1000000010011100110011000000000000000010000000001
1000000010001000000011000000000000000010000000001
1000000010000000000000000000000000000010000000001
1000000010000000000000000000000000000010000000001
1000000010000000000000000000000000000010000000001
1000000010011100110011000000000000000010000000001
1011001110000000000000000000000000000010000000001
1001001110000000000000000000000000000010000000001
1000000010000000000000000000000000000010000000001
1001001110000000000000000000000000000010000000001
1011001011111111111111111111111111111100000000001
1000000000000000000000000000000000000000000000001
1000000000000000000000000000000000000000000000001
1000000000000000000000000000000000000000000000001
1000000000011111111111111111111111000000000000001
1000000000000000000000000000000000000000000000001
1000000000000000000000000000000000000000000000001
1000000000000000000000000000000000000000000000001
1000000000000000000000000000000000000000000000111
1111111111111111111111111111111111111111111111111
