11111111111111111111111111111111111111111111111111
10000000000000000000000000000000000000000000001111
10000000000000000000000000000000000000000000000011
10000000000000000000000000000000000000000000000011
10000000000000011111100000000000000000000000000011
10000000000000000001000000011111110000000000000011
10000000000110000000000000000000010000000000000011
10000000000110000000000000000000111000000000000011
10000000000000100000000000000000010000000000000011
10000000100000000000000000000000000000100000000011
10000000100000000000000000000000000000100000000011
10000000100000110000110000000000000000100000000011
10000000100000110000110000000000000000100000000011
10000000100000000000000000000000000000100000000011
10000000100000000000000000000000000000100000000011
10000000100111001100110000000000000000100000000011
10000000100010000000110000000000000000100000000011
10000000100000000000000000000000000000100000000011
10000000100000000000000000000000000000100000000011
10000000100000000000000000000000000000100000000011
10000000100111001100110000000000000000100000000011
10110011100000000000000000000000000000100000000011
10010011100000000000000000000000000000100000000011
10000000100000000000000000000000000000100000000011
10010011100000000000000000000000000000100000000011
10110010111111111111111111111111111111000000000011
10000000000000000000000000000000000000000000000011
10000000000000000000000000000000000000000000000011
10000000000000000000000000000000000000000000000011
10000000000111111111111111111111110000000000000011
10000000000000000000000000000000000000000000000011
10000000000111111111111111111111110000000000000011
10000000000000000000000000000000000000000000000011
10000000000111111111111111111111110000000000000011
10000000000000000000000000000000000000000000000011
10000000000111111111111111111111110000000000000011
10000000000000000000000000000000000000000000000011
10000000000111111111111111111111110000000000000011
10000000000000000000000000000000000000000000000011
10000000000111111111111111111111110000000000000011
10000000000000000000000000000000000000000000000011
10000000000111111111111111111111110000000000000011
10000000000000000000000000000000000000000000000011
10000000000111111111111111111111110000000000000011
10000000000000000000000000000000000000000000000011
10000000000000000000000000000000000000000000000011
10000000000000000000000000000000000000000000000011
10000000000000000000000000000000000000000000001111
11111111111111111111111111111111111111111111111111
11111111111111111111111111111111111111111111111111