111111111111111111111111111111111111111111
100000000000000000000000000000000000011111
100000000000000000000000000000000000001111
110000000000000000000000000000000000000111
100000110010010010010011000000000000000111
100000000000000000000000000110000000000111
100000000000000000000000000001100000000111
110000000000000000000000000000010000000111
110000000111111000000000000000000100000011
100000000110001110000000000000000000000011
100000000110000000000000000000000000000011
100000000110000000000000110000000000000011
100000001110000000100000011111111110000001
110000000110001000010000000000011000000001
100000000110000010000000000000011000000001
100000000110000000010000000000011000000001
100000000110001000010000000000011000000001
100000001110000010000000000000111000000011
110000000110000001000000000000011000000001
100000000110001100001000000000011000000001
100000000110000000000000000000011000000001
100000000110000000000000000000011000000001
100000000110000000000000000000111000000011
110000000111000110000100000000011100000001
100000000110000000100000000000011000000001
100000000110000000100000000000011000000001
100000000110000110000100000000011000000001
100000000110000000000000000000011000000011
110000000111000000010000000000011100000001
100000000110000011000010000000011100000001
100000000110000000000000000000011000000001
100000000110000000000000000000011000000001
100000000110000000000000000000011000000011
110000000011000000000000000000001100000001
100000000111000000100000000000011100000001
100000000110000000100001000000011000000001
100000000110000000001100000000011000000001
100000000110000000100000000000011000000011
110000000011000000010000100000001100000001
100000000011000000000000000000011100000001
100000000111000000000100000000011100000001
100000000110000000010000110000011000000001
100000000110000000000000000000011000000011
110000000011000000000000000000001100000001
100000000011000000000000000000001100000001
100000000111000000000000000000011100000001
100000000111000000000000000000011000000001
100000000010111110000000010000011000000011
110000100010000000000000001111111000000011
100000100010000000000000000000011000000011
100001100000000000000000000000000000000111
100001100000000000000000000000000010000111
100000110000100100100100110010000010001111
100000000000000000000000000000000110001111
100000000000000000000000000000011000001111
110000000000000000000000000000000000011111
111111111111111111111111111111111111111111
