00000000000000000000000000000000000000000000000000
00000000000011111111111111111111111111111111111110
00000000000100000000000000000000000000000000000011
00000000000100000000000000000000000000000000000001
00000000001100000000000000000000000000000000000001
00000000001000001100100100100100110000000000000001
00000000001000000000000000000000000001100000000001
00000000001000000000000000000000000000011000000001
00000000011000000000000000000000000000001000000011
00000000011000000011111000000000000000000100000010
00000000010000000010001110000000000000000000000010
00000000010000000010000000000000000000000000000010
00000000010000000010000000000000110000000000000010
00000000010000000110000000100000011111110000000110
00000000110000000100010000100000000000100000000100
00000000100000000100000100000000000000100000000100
00000000100000000100000000100000000000100000000100
00000000100000000100010000100000000000100000000100
00000000100000001100000100000000000001100000001100
00000001100000001000000100000000000001000000001000
00000001000000001000110000100000000001000000001000
00000001000000001000000000000000000001000000001000
00000001000000001000000000000000000001000000001000
00000001000000001000000000000000000011000000011000
00000011000000011000110000100000000011000000010000
00000010000000010000000100000000000010000000010000
00000010000000010000000100000000000010000000010000
00000010000000010000110000100000000010000000010000
00000010000000010000000000000000000010000000110000
00000110000000110000000100000000000110000000110000
00000100000000100000110000100000000110000000100000
00000100000000100000000000000000000100000000100000
00000100000000100000000000000000000100000000100000
00000100000000100000000000000000000100000001100000
00001100000000100000000000000000000100000001000000
00001000000001100000010000000000001100000001000000
00001000000001000000010000100000001000000001000000
00001000000001000000000110000000001000000001000000
00001000000001000000010000000000001000000011000000
00011000000001000000010000100000001000000010000000
00010000000001000000000000000000011000000010000000
00010000000011000000000100000000011000000010000000
00010000000010000000010000110000010000000010000000
00010000000010000000000000000000010000000110000000
00110000000010000000000000000000010000000110000000
00100000000010000000000000000000010000000100000000
00100000000110000000000000000000110000000100000000
00100000000110000000000000000000100000000100000000
00100000000001111100000000100000100000001100000000
01100001000000000000000000111111100000001000000000
01000001000000000000000000000001100000001000000000
01000011000000000000000000000000000000001000000000
01000011000000000000000000000000000100001000000000
01000001100001001001001001100100000100011000000000
01000000000000000000000000000000001100011000000000
01000000000000000000000000000000110000010000000000
01100000000000000000000000000000000000110000000000
00111111111111111111111111111111111111100000000000
