11111111111111111111111111111111111111111111111111
10000000000000000000000000000000000001111111111111
10000000000000000000000000000000000000111111111111
11000000000000000000000000000000000000011111111111
10000011001001001001001100000000000000011111111111
10000000000000000000000000011000000000011111111111
10000000000000000000000000000110000000011111111111
11000000000000000000000000000001000000011111111111
11000000011111100000000000000000010000001111111111
10000000011000111000000000000000000000001111111111
10000000011000000000000000000000000000001111111111
10000000011000000000000011000000000000001111111111
10000000111000000010000001111111111000000111111111
11000000011000100001000000000001100000000111111111
10000000011000001000000000000001100000000111111111
10000000011000000001000000000001100000000111111111
10000000011000100001000000000001100000000111111111
10000000111000001000000000000011100000001111111111
11000000011000000100000000000001100000000111111111
10000000011000110000100000000001100000000111111111
10000000011000000000000000000001100000000111111111
10000000011000000000000000000001100000000111111111
10000000011000000000000000000011100000001111111111
11000000011100011000010000000001110000000111111111
10000000011000000010000000000001100000000111111111
10000000011000000010000000000001100000000111111111
10000000011000011000010000000001100000000111111111
10000000011000000000000000000001100000001111111111
11000000011100000001000000000001110000000111111111
10000000011000001100001000000001110000000111111111
10000000011000000000000000000001100000000111111111
10000000011000000000000000000001100000000111111111
10000000011000000000000000000001100000001111111111
11000000001100000000000000000000110000000111111111
10000000011100000010000000000001110000000111111111
10000000011000000010000100000001100000000111111111
10000000011000000000110000000001100000000111111111
10000000011000000010000000000001100000001111111111
11000000001100000001000010000000110000000111111111
10000000001100000000000000000001110000000111111111
10000000011100000000010000000001110000000111111111
10000000011000000001000011000001100000000111111111
10000000011000000000000000000001100000001111111111
11000000001100000000000000000000110000000111111111
10000000001100000000000000000000110000000111111111
10000000011100000000000000000001110000000111111111
10000000011100000000000000000001100000000111111111
10000000001011111000000001000001100000001111111111
11000010001000000000000000111111100000001111111111
11111111111111111111111111111111111111111111111111